PERMITTED_VALUE	DESCRIPTION	DEFINITION
CCR4	CCR4 Gene	This gene is involved in chemokine-dependent G protein-coupled receptor signaling.
AFF1	AFF1 Gene	This gene is involved in transcriptional regulation and translocations in the gene are associated with acute leukemia.
ACVR2A	ACVR2A Gene	This gene plays a role in the transforming growth factor-beta signal transduction pathway through constitutive kinase activity.
ACVR1	ACVR1 Gene	This gene plays a role in the transforming growth factor-beta signal transduction pathway through serine/threonine specificity.
ACSL6	ACSL6 Gene	This gene is involved in the biosynthesis of lipids.
ACSL3	ACSL3 Gene	This gene is involved in lipid biosynthesis.
ACKR3	ACKR3 Gene	This gene is involved in the regulation of chemokine signaling.
ABL2	ABL2 Gene	This gene plays a role in signal transduction.
ABL1	ABL1 Gene	This gene is involved in cell adhesion, differentiation, division and stress response.
ABI1	ABI1 Gene	This gene plays a role in signal transduction and negative regulation of cell proliferation.
CALR	CALR Gene	This gene plays a role in calcium binding and protein folding.
CACNA1D	CACNA1D Gene	This gene is involved in voltage-dependent calcium transport.
C15orf65	C15orf65 Gene	This gene has no known function.
BUB1B	BUB1B Gene	This gene is involved in mitotic progression.
BTK	BTK Gene	This gene is involved in both signaling and B-cell development.
BTG1	BTG1 Gene	This gene is involved in the regulation of cell proliferation.
BRIP1	BRIP1 Gene	This gene is involved in DNA double-strand break repair.
BRD4	BRD4 Gene	This gene plays a role in mitosis.
BRD3	BRD3 Gene	This gene may play a role in both histone acetylation and transcriptional regulation.
BRCA2	BRCA2 Gene	BRCA2 putatively functions as a tumor suppressor gene, however, its exact function has not been well characterized. The similarity of, and functional analysis of, BRCA2 and BRCA1 proteins, suggests that these proteins function in the same genetic pathway. BRCA1 and BRCA2 have transcriptional activation potential and the two proteins are associated with the activation of double-strand break repair and/or homologous recombination. The two proteins have been shown to coexist and colocalize in a biochemical complex. (from LocusLink)
BRCA1	BRCA1 Gene	This gene plays a role in cell cycle control, regulation of transcription and the maintenance of genomic stability. It is also involved in the inhibition of mammary cell growth.
BRAF	BRAF Gene	This gene is involved in cell organization/biogenesis and the inhibition of apoptosis.
BMPR1A	BMPR1A Gene	This gene plays a role in the bone morphogenetic protein signaling pathway.
BMP5	BMP5 Gene	This gene plays a role in the regulation of mesenchymal differentiation. It is involved in cartilage and bone formation.
BLM	BLM Gene	This gene plays a role in DNA unwinding and recombination-mediated telomere lengthening.
BIRC6	BIRC6 Gene	This gene regulates the apoptotic program via signal transduction in the ubiquitination pathway.
BIRC3	BIRC3 Gene	This anti-apoptotic gene regulates apoptotic activity. BIRC3 gene promotes tumor cell survival.
BCORL1	BCORL1 Gene	This gene plays a role in the inhibition of gene expression.
BCOR	BCOR Gene	This gene plays a role in the repression of gene transcription.
BCLAF1	BCLAF1 Gene	Human BCLAF1 wild-type allele is located within 6q22-q23 and is approximately 33 kb in length. This allele, which encodes Bcl-2-associated transcription factor 1 protein, plays a role in both apoptosis promotion and the repression of transcription.
BCL9L	BCL9L Gene	This gene plays a role in the coactivation of gene transcription.
BCL9	BCL9 Gene	This gene plays a role in signal transduction and is involved in development.
BCL7A	BCL7A Gene	This gene may play a role in signal transduction.
BCL6	BCL6 Gene	This gene is involved in transcriptional repression and plays a role in the modulation of B-cell responses.
BCL3	BCL3 Gene	This gene is involved in transcriptional co-activation and signal transduction.
BCL2L12	BCL2L12 Gene	This gene is involved in the regulation of apoptosis.
BCL2	BCL2 Gene	A protein that helps control whether a cell lives or dies by blocking a type of cell death called apoptosis. The gene for BCL2 is found on chromosome 18, and transfer of the BCL2 gene to a different chromosome is seen in many B-cell leukemias and lymphomas. This causes the BCL2 protein to be made in larger amounts, which may keep cancer cells from dying.
BCL11B	BCL11B Gene Immunodeficiency Syndrome	This gene may play a role in tumor suppression, signaling and T cell development.: A deficiency of immune response or a disorder characterized by deficient immune response.
BCL11A	BCL11A Gene	This gene is involved in both the modulation of cell shape and lymphopoiesis.
BCL10	BCL10 Gene	This gene is involved in the promotion of apoptosis.
BARD1	BARD1 Gene	This gene plays a role in cellular response and is susceptible to oncogenic mutations in breast and ovarian cancers.
BAP1	BAP1 Gene	This gene is involved in cellular growth regulation and is purported to have tumor suppression activity.
B2M	B2M Gene	This gene plays a role in immune responses.
AXIN2	AXIN2 Gene	This gene is involved in signal transduction and plays a role in development.
AXIN1	AXIN1 Gene	This gene plays a role in signal transduction and is involved in development.
ATRX	ATRX Gene	This gene plays a role in the regulation of both chromatin remodeling and transcription.
ATR	ATR Gene	This gene is involved in cell cycle checkpoints and DNA recombination.
ATP2B3	ATP2B3 Gene	This gene plays a role in ATP-dependent calcium transport.
ATP1A1	ATP1A1 Gene	This gene is involved in both ion transport and ATP metabolism.
ATM	ATM Gene	This gene is involved in apoptosis, DNA repair and cell cycle regulation.
ATIC	ATIC Gene	This gene plays a role in purine biosynthesis.
ATF1	ATF1 Gene	This gene is involved in the modulation of transcription.
ASXL2	ASXL2 Gene	This gene plays a role in both chromatin modification and the positive regulation of transcription.
ASXL1	ASXL1 Gene	This gene may be involved in both transcriptional regulation and chromatin remodeling.
ASPSCR1	ASPSCR1 Gene	This gene is involved in the modulation of blood glucose levels.
ARNT	ARNT Gene	This gene is involved in xenobiotic metabolism and receptor-ligand mediated interactions.
ARID2	ARID2 Gene	This gene is involved in both transcriptional regulation and chromatin remodeling.
ARID1B	ARID1B Gene	This gene plays a role in both chromatin remodeling and transcriptional regulation.
ARID1A	ARID1A Gene	This gene plays a role in transcriptional regulation.
ARHGEF12	ARHGEF12 Gene	This gene plays a role in both G-protein coupled receptor- and Rho-mediated signaling.
ARHGAP5	ARHGAP5 Gene	This gene is involved in the regulation of GTPase activity.
ARHGAP26	ARHGAP26 Gene	This gene plays a role in signal transduction.
ARAF	ARAF Gene	This gene plays a role in signal transduction and the cellular response to mitogens.
AR	AR Gene	This gene plays a role in the transcriptional activation of androgen responsive genes.
APOBEC3B	APOBEC3B Gene	This gene plays a role in viral DNA cytosine deamination.
APC	APC Gene	This gene plays a role in signal transduction. It is involved in both adhesion and migration of cells.
ANK1	ANK1 Gene	This gene plays a role in red blood cell morphology.
AMER1	AMER1 Gene	This gene may play a role in kidney development.
ALK	ALK Gene	This gene is involved in brain development and neuronal specificity.
ALDH2	ALDH2 Gene	This gene plays a role in intermediary metabolism.
AKT3	AKT3 Gene	This gene is involved in signal transduction and the inhibition of apoptosis.
AKT2	AKT2 Gene	This gene plays a role in glucose homeostasis and the inhibition of apoptosis.
AKT1	AKT1 Gene	This gene is involved in signal transduction and negative regulation of apoptosis. It also plays a role in glucose transport, glycogen synthesis, protein synthesis and neuronal survival.
AKAP9	AKAP9 Gene	This gene plays a role in signal transduction and modulates synaptic transmission.
AFF4	AFF4 Gene	This gene plays a regulatory role in transcription and is involved in male germ cell differentiation.
AFF3	AFF3 Gene	This gene is involved in transcriptional activation and is purported to play roles in lymphoid development and oncogenesis.
A1CF	A1CF Gene	This gene is involved in the deamination of APOB mRNA.
TRD	T-Cell Receptor Delta Locus	This region represents the germline organization of the T cell receptordelta locus. The delta locus includes V (variable), J (joining), diversity (D), and C (constant) segments. During T cell development, the delta chain is synthesized by a recombination event at the DNA level joining a D segment with a J segment; a V segment is then joined to the D-J gene. The C segment is later joined by splicing at the RNA level. Recombination of many different V segments with several D and J segments provides a wide range of antigen recognition. Additional diversity is attained by junctional diversity, resulting from the random additional of nucleotides by terminal deoxynucleotidyltransferase. (from LocusLink)
TRB	T-Cell Receptor Beta Locus	This region represents the germline organization of the T cell receptor beta locus. The beta locus includes V (variable), J (joining), diversity (D), and C (constant) segments. During T cell development, the beta chain is synthesized by a recombination event at the DNA level joining a D segment with a J segment; a V segment is then joined to the D-J gene. The C segment is later joined by splicing at the RNA level. Recombination of many different V segments with several D and J segments provides a wide range of antigen recognition. Additional diversity is attained by junctional diversity, resulting from the random additional of nucleotides by terminal deoxynucleotidyltransferase.  Chromosomal abnormalities involving the T-cell receptor beta locus have been associated with T-cell lymphomas. (from LocusLink)
TRAF7	TRAF7 Gene	This gene is involved in both MAPK signaling and protein ubiquitination.
TRA	T-Cell Receptor Alpha Locus	This region represents the germline organization of the T cell receptor alpha locus. The alpha locus includes V (variable), J (joining), and C (constant) segments. During T cell development, the alpha chain is synthesized by a recombination event at the DNA level joining a V segment with a J segment. The C segment is later joined by splicing at the RNA level. Recombination of many different V segments with several J segments provides a wide range of antigen recognition. Additional diversity is attained by junctional diversity, resulting from the random additional of nucleotides by terminal deoxynucleotidyltransferase. (from LocusLink)
TPR	TPR Gene	This gene plays a role in both nuclear transport and mitosis.
TPM4	TPM4 Gene	This gene is involved in smooth muscle cell contraction.
TPM3	TPM3 Gene	This gene plays a role in muscle contraction.
TP63	TP63 gene	This gene plays a role in both transcriptional regulation and limb development.
TP53	TP53 Gene	This gene plays a critical role in cell cycle regulation and has tumor suppressor activity.
TOP1	TOP1 Gene	This gene is involved in the regulation of both DNA topology and transcription.
TNFRSF17	TNFRSF17 Gene	This gene is involved in the modulation of cytokine signaling.
TNFRSF14	TNFRSF14 Gene	This gene plays a role in receptor signaling.
TNFAIP3	TNFAIP3 Gene Immunodeficiency Syndrome	This gene may play a role in the regulation of apoptosis.: A deficiency of immune response or a disorder characterized by deficient immune response.
TNC	TNC Gene	This gene is involved in cell adhesion, differentiation and proliferation.
TMPRSS2	TMPRSS2 Gene	This gene plays a role in the activation of pathway signaling.
TMEM127	TMEM127 Gene	This gene may play a role in signaling and protein trafficking.
TLX3	TLX3 Gene	This gene may be involved in transcriptional regulation.
TLX1	TLX1 Gene	This gene plays a role in transcriptional regulation and organogenesis. Translocations in the gene are associated with acute T-cell leukemia.
THRAP3	THRAP3 Gene	This gene is involved in the activation of transcription.
TGFBR2	TGFBR2 Gene	This gene plays a role in cellular proliferation and mitogenic responses.
TFRC	TFRC Gene	This gene plays a regulatory role in receptor-mediated endocytosis and iron metabolism.
TFPT	TFPT Gene	This gene plays a role in the regulation of apoptosis.
TFG	TFG Gene	This gene is involved in signaling.
TFEB	TFEB Gene	This gene plays a role in transcription.
TFE3	TFE3 Gene	This gene plays a role in transcriptional activation. It is involved in melanogenesis.
TET2	TET2 Gene	This gene is involved in oxidation.
TET1	TET1 Gene	This gene is involved in the regulation of DNA methylation.
TERT	TERT Gene	This gene is involved in cell cycle regulation and telomere maintenance.
TEC	TEC gene	This gene is involved in signal transduction and regulation of immune function.
TCL1A	TCL1A Gene	This gene is involved in signal transduction.
TCF7L2	TCF7L2 Gene	This gene plays a role in signal transduction and regulation of transcription.
TCF3	TCF3 Gene	This gene plays a role in regulation of transcription. It is involved in the control of tissue-specific cell fate during embryogenesis.
TCF12	TCF12 Gene	This gene is involved in both transcriptional regulation and tissue differentiation.
TCEA1	TCEA1 Gene	This gene is involved in transcription.
TBX3	TBX3 Gene	This gene is involved in both transcriptional repression and limb development.
TBL1XR1	TBL1XR1 Gene	This gene is involved in transcriptional activation.
TAL2	TAL2 Gene	This gene is involved in transcriptional regulation. It plays a role in T-cell acute lymphocytic leukemia.
TAL1	TAL1 Gene	This gene plays a role in regulation of transcription and cell organization. It is involved in both embryonic hematopoiesis and adult erythropoiesis.
TAF15	TAF15 Gene	This gene plays a role in transcriptional initiation.
SYK	SYK Gene	This gene plays a role in receptor tyrosine phosphorylation signal transduction, phagocytosis, endothelial cell growth and proliferation.
SUZ12	SUZ12 Gene	This gene plays a role in embryonic development and histone methylation.
SUFU	SUFU Gene	This gene plays a role in the regulation of both transcription and signaling.
STRN	STRN Gene	This gene may play a role in cell scaffolding or calcium signaling.
STK11	STK11 Gene	This gene plays a role in cell cycle regulation. It is also putatively involved in glucose production.
STIL	STIL Gene	This gene plays a role in both cellular proliferation and embryonic development.
STAT6	STAT6 Gene	This gene plays a role in signal transduction and activation of transcription.
STAT5B	STAT5B Gene	This gene is involved in signal transduction and activation of transcription. It plays a role in the immune response via stimulation of T-cell proliferation.
STAT3	STAT3 Gene	This gene plays a role in signal transduction and activation of transcription. It is involved in regulation of both apoptosis and cell growth.
STAG2	STAG2 Gene	This gene is involved in cell division.
STAG1	STAG1 Gene	This gene plays a role in sister chromatid binding.
SSX4	SSX4 Gene	This gene may be involved in transcriptional modulation.
SSX2	SSX2 Gene	This gene may play a role in transcriptional regulation.
SSX1	SSX1 Gene	This gene may be involved in the regulation of transcription.
SS18L1	SS18L1 Gene	This gene plays a role in the positive regulation of transcription.
SS18	SS18 Gene	This gene is involved in transcriptional activation.
SRSF3	SRSF3 Gene	This gene plays a role in RNA splicing and export.
SRSF2	SRSF2 Gene	This gene plays a role in RNA splicing.
SRGAP3	SRGAP3 Gene	This gene plays a role in GTPase-mediated signaling.
SRC	SRC Gene	This gene is involved in apoptosis, hormonogenesis, focal adhesion and the formation of intercellular junctions.
KDSR	KDSR Gene	This gene plays a role in glycosphingolipid metabolism.
ZNF198	ZMYM2 Gene	This gene plays a role in transcriptional modulation.
TSC2	TSC2 Gene	This gene plays a role in signal transduction and cell cycle control. It is involved in cell adhesion, differentiation, growth and migration.
TSC1	TSC1 Gene	This gene is involved in cell cycle regulation and the loss of cellular adhesion.
SFRP4	SFRP4 Gene	This gene plays a role in signal transduction, apoptosis and cell proliferation.
RAD21	RAD21 Gene	This gene is involved in chromosomal cohesion, DNA repair and apoptosis.
PTPRC	PTPRC Gene	This gene plays a role in suppression of cytokine receptor signaling and the regulation of signal transduction in lymphocytes.
PLCG1	PLCG1 Gene	This gene is involved in both intracellular signaling and second messenger production.
PIK3CA	PIK3CA Gene	This gene is involved in apoptosis, cell growth and angiogenesis.
PGR	PGR Gene	This gene plays a role in the signal transduction processes that are involved in pregnancy.
NT5C2	NT5C2 Gene	This gene plays a role in purine metabolism.
MUC4	MUC4 Gene	This gene is involved in both cell adhesion and receptor signaling.
MUC1	MUC1 Gene	This gene plays a role in cellular signal transduction and is used as a biomarker for breast cancer.
MLH2	PMS1 Gene	This gene is involved in mismatch repair and mutations in the gene result in hereditary non-polyposis colon cancer 3.
MKL1	MKL1 Gene	This gene is involved in transcriptional modulation and muscle cell differentiation.
LMNA	LMNA Gene	This gene is involved in the architecture of nuclear membrane construction.
HLA-A	HLA-A Gene	This gene is involved in immune responses and histocompatibility processes.
GNA11	GNA11 Gene	This gene is involved in signal transduction.
GLI1	GLI1 Gene	This gene plays a regulatory role in transcription and embryonic development.
FLT3	FLT3 Gene	This gene plays a role in hematopoiesis and may function as a growth factor receptor.
ESR1	ESR1 Gene	This gene is involved in ligand-activated transcriptional activity.
ERBB2	ERBB2 Gene	This gene plays a role in cellular proliferation and is involved in the oncogenic process through amplification and/or overexpression in several cancers.
EPAS1	EPAS1 Gene	This gene plays a role in the cellular response to hypoxia.
DDX3X	DDX3X Gene	This gene is involved in RNA binding.
EPS15	EPS15 Gene	This gene plays a role in signal transduction and cell proliferation.
ERBB3	ERBB3 Gene	This gene is involved in signal transduction pathways that result in cellular proliferation or differentiation. The gene has also been associated with numerous cancers.
EPHA7	EPHA7 Gene	This gene plays a role in mediation of developmental processes.
EPHA3	EPHA3 Gene	This gene is involved in receptor tyrosine kinase signal transduction and plays a role in lymphoid function and differentiation.
EP300	EP300 Gene	This gene plays a role in DNA repair and regulation of transcription.
EML4	EML4 Gene	This gene may play a role in cytoskeletal assembly.
ELN	ELN Gene	This gene is involved in the structure of the extracellular matrix.
ELL	ELL Gene	This gene is involved in the modulation of transcription.
ELK4	ELK4 Gene	This gene is involved in the regulation of transcription.
ELF4	ELF4 Gene	This gene plays a role in both DNA binding and transcriptional activation.
ELF3	ELF3 Gene	This gene is involved in the regulation of both transcription and epithelial cell differentiation. It also plays a role in angiogenesis.
EIF4A2	EIF4A2 Gene	This gene is involved in translation initiation.
EIF3E	EIF3E Gene	This gene is involved in the initiation and regulation of protein translation.
EIF1AX	EIF1AX Gene	This gene is involved in translation initiation and efficiency.
EGFR	EGFR Gene	This gene is involved in the epidermal growth factor signal transduction pathway.
EED	EED Gene	This gene plays a role in the negative regulation of transcription.
ECT2L	ECT2L Gene	This gene may be involved in guanine nucleotide exchange.
EBF1	EBF1 Gene	This gene plays a role in transcriptional activation.
DUX4L1	DUX4L1 Gene	Human DUX4L1 gene is located in the vicinity of 4q35 and is approximately 2 kb in length. The product is a processed pseudogene that produces an RNA transcript, but does not encode a protein product. This gene is within a D4Z4 repeat array; contraction of this macrosatellite repeat is associated with facioscapulohumeral muscular dystrophy (FSHD).
DROSHA	DROSHA Gene	This gene plays a role in the processing of microRNA in the nucleus.
DNMT3A	DNMT3A Gene	This gene is involved in epigenetic modification of DNA.
DNM2	DNM2 Gene	This gene plays a role in both GTP hydrolysis and microtubule organization.
DNAJB1	DNAJB1 Gene	This gene plays a role in the regulation of protein folding.
DICER1	DICER1 Gene	This gene is involved in the RNA interference pathway.
DGCR8	DGCR8 Gene	This gene plays a role in microRNA processing.
DEK	DEK Gene	This gene is involved in RNA processing and regulation of chromatin organization.
DDX6	DDX6 Gene	This gene plays a role in the translation of mRNA encoded by genes involved in cell proliferation and malignant transformation.
DDX5	DDX5 Gene	This gene is involved in the mediation of RNA metabolism.
DDX10	DDX10 Gene	This gene plays a role in both RNA metabolism and ATP hydrolysis.
DDR2	DDR2 Gene	This gene plays a role in extracellular matrix communication processes and receptor-mediated signal transduction.
DDIT3	DDIT3 Gene	This gene plays a role in the modulation of transcription.
DDB2	DDB2 Gene	This gene plays a role in DNA repair.
DCTN1	DCTN1 Gene	This gene is involved in the modulation of retrograde transport of cytoplasmic organelles and vesicles.
DCC	DCC Gene	This gene plays a role in the regulation of several processes that determine neuronal cell morphology.
DCAF12L2	DCAF12L2 Gene	This gene may play a role in protein complex formation.
DAXX	DAXX Gene	This gene plays a role in signal transduction, regulation of transcription and enhancement of apoptosis.
CYSLTR2	CYSLTR2 Gene	This gene is involved in cysteinyl leukotriene binding and signal transduction.
CYP2C8	CYP2C8 Gene	This gene plays a role in drug metabolism. It is also involved in the oxidation of both endobiotics and xenobiotics.
CYLD	CYLD Gene	This gene is involved in protein deubiquitination.
CXCR4	CXCR4 gene	This gene is involved in the mediation of viral entry into cells and cellular migration and chemotaxis.
CUX1	CUX1 Gene	This gene is involved in both transcriptional regulation and Golgi vesicle transport.
CUL3	CUL3 Gene	This gene plays a role in protein degradation and cell cycle arrest.
CTNND2	CTNND2 Gene	This gene is involved in the regulation of both transcription and signal transduction.
CTNND1	CTNND1 Gene	This gene plays a role in signal transduction.
CTNNB1	CTNNB1 Gene	This gene is involved in signal transduction and regulation of transcription.
CTNNA2	CTNNA2 Gene	This gene is involved in cell-cell adhesion and cellular differentiation in the nervous system.
CTCF	CTCF Gene	This gene is involved in epigenetic control of gene expression.
CSMD3	CSMD3 Gene	This gene plays a role in neuronal development.
CSF3R	CSF3R Gene	This gene plays an inhibitory role in cell survival and proliferation.
CSF1R	CSF1R Gene	This gene is essential for the regulation of the production, differentiation, and function of macrophages.
CRTC3	CRTC3 Gene	This gene is involved in transcriptional regulation.
CRTC1	CRTC1 Gene	This gene plays a role in the positive regulation of transcription.
CRNKL1	CRNKL1 Gene	This gene is involved in RNA binding and pre-mRNA splicing.
CRLF2	CRLF2 Gene	This gene is involved in cytokine binding and signaling.
CREBBP	CREBBP Gene	This gene plays a role in transcriptional regulation and in NF-kappa B signal transduction.
CREB3L2	CREB3L2 Gene	This gene is involved in the response to cellular stress.
CREB3L1	CREB3L1 Gene	This gene plays a role in transcriptional regulation in response to cellular stress.
CREB1	CREB1 Gene	This gene is involved in transcriptional regulation and its activity is modulated in response to hormonal stimulation from the cAMP pathway.
COX6C	COX6C Gene	This gene is involved in mitochondrial respiration.
COL3A1	COL3A1 Gene	This gene plays a role in collagen formation in connective tissues.
COL2A1	COL2A1 Gene	This gene plays a role in both skeletal development and cartilage structure.
COL1A1	COL1A1 Gene	This gene plays an important structural role in cartilage and mutations in the gene are associated with osteogenesis imperfecta.
CNTRL	CNTRL Gene	This gene plays a role in cell cycle progression.
CNTNAP2	CNTNAP2 Gene	This gene may be involved in axonal structure.
CNOT3	CNOT3 Gene	This gene is involved in mRNA degradation, miRNA-mediated repression, translational regulation and general transcription regulation.
CNBP	CNBP Gene	This gene is involved in sterol-mediated transcription.
CNBD1	CNBD1 Gene	This gene is involved in cyclic nucleotide binding.
CLTCL1	CLTCL1 Gene	This gene is involved in both receptor-mediated endocytosis and vesicle formation.
CLTC	CLTC Gene	This gene plays a role in both the formation of cellular vesicles and receptor-mediated endocytosis.
CLP1	CLP1 Gene	This gene plays a role in RNA processing.
CLIP1	CLIP1 Gene	This gene plays a role in both endocytosis and mitosis.
CIITA	CIITA Gene	This gene plays a role in transcriptional regulation.
CIC	CIC Gene	This gene is involved in the modulation of transcription.
CHST11	CHST11 Gene	This gene plays a role in the metabolism of chondroitin sulfate.
CHIC2	CHIC2 Gene	This gene may play a role in vesicular transport.
CHEK2	CHEK2 Gene	This gene plays a role in cell survival and the negative regulation of cell growth.
CHD4	CHD4 Gene	This gene is involved in ATP-dependent chromatin remodeling.
CHD2	CHD2 Gene	This gene may be involved in the regulation of both gene expression and chromatin modification.
CHCHD7	CHCHD7 Gene	This gene may be involved in stature.
CEP89	CEP89 Gene	This gene is involved in cilia formation.
CEBPA	CEBPA Gene	This gene plays a role in body weight homeostasis and cellular proliferation. Mutations in the gene are associated with acute myeloid leukemia.
CDX2	CDX2 Gene	This gene plays a role in transcriptional initiation, embryonic axial elongation and patterning.
CDKN2C	CDKN2C Gene	This gene is involved in cell cycle inhibition and regulation.
CDKN2A	CDKN2A Gene	This gene functions as a tumor suppressor and transcriptional regulator.
CDKN1B	CDKN1B Gene	This gene is involved in cell cycle regulation and cyclin regulation.
CDKN1A	CDKN1A Gene	This gene is a regulator of cell cycle progression at the G1 phase of the cell cycle.
CDK6	CDK6 Gene	This gene plays a role in the progression of the cell cycle.
CDK4	CDK4 Gene	This gene is involved in G1 stage cell cycle progression.
CDK12	CDK12 Gene	This gene is involved in protein phosphorylation, RNA splicing and transcription elongation.
CDH17	CDH17 Gene	This gene is involved in cell-cell adhesion and intestinal proton-dependent peptide transport.
CDH11	CDH11 Gene	This gene is involved in the adherens junction.
CDH10	CDH10 Gene	This gene plays a role in the modulation of neuronal cell shape and cell-cell adhesion.
CDH1	CDH1 Gene	This gene plays a role in cell-cell adhesion and loss of function contributes to the progression of many carcinomas.
CDC73	CDC73 Gene	This gene is involved in transcription and may play a role in cell cycle progression.
CD99	CD99 Gene	This gene plays a role in the cell adhesion process.
CD79B	CD79B Gene	This gene plays a role in signaling in B-cells.
CD79A	CD79A Gene	This gene is involved in B-cell signaling and proliferation.
CD74	CD74 Gene	This gene plays a role in antigen processing and presentation.
CD28	CD28 Gene	This gene plays several roles in cellular functions specific to the T-cell.
Not Reported 	Not Reported	Not provided or available.
Unknown 	Unknown	Not known, observed, recorded; or reported as unknown by the data contributor.
ZRSR2	ZRSR2 Gene	This gene is involved in mRNA processing.
ZNRF3	ZNRF3 Gene	This gene is involved in protein ubiquitination and Wnt pathway inhibition.
ZNF521	ZNF521 Gene	This gene plays a role in both the positive and negative regulation of transcription.
ZNF479	ZNF479 Gene	This gene may play a role in the regulation of gene transcription.
ZNF444	ZNF444 Gene	This gene is involved in both transcriptional regulation and DNA binding.
ZNF429	ZNF429 Gene	This gene may play a role in the regulation of gene transcription.
ZNF384	ZNF384 Gene	This gene is involved in both transcriptional regulation and DNA binding.
ZNF331	ZNF331 Gene	This gene plays a role in transcriptional regulation.
ZMYM3	ZMYM3 Gene	This gene is involved in chromatin modification.
ZFHX3	ZFHX3 Gene	This gene is involved in myoblast and neuronal differentiation.
ZEB1	ZEB1 gene	This gene is involved in the transcriptional repression of interleukin 2.
ZCCHC8	ZCCHC8 Gene	This gene plays a role in RNA binding.
ZBTB16	ZBTB16 Gene	This gene plays a role in apoptosis and regulation of transcription. It is also involved in cell organization/biogenesis and megakaryocytic development.
YWHAE	YWHAE Gene	This gene plays a role in signaling.
XPO1	XPO1 Gene	This gene plays a role in the regulation of nuclear export.
XPC	XPC Gene	This gene is involved in nucleotide excision repair.
XPA	XPA Gene	This gene facilitates DNA binding in repair processes and is associated with the disease xeroderma pigmentosum complementation group A.
WWTR1	WWTR1 Gene	This gene is involved in regulation of transcription. It is involved in fetal/neonatal cardiac and muscle development.
WT1	WT1 Gene	This gene plays a role in regulation of transcription. It is involved in the control of both cell differentiation and proliferation.
WRN	WRN Gene	This gene is involved in DNA repair and the unwinding of DNA.
WNK2	WNK2 Gene	This gene plays a role in electrolyte homeostasis, cell signaling, cell survival, and cellular proliferation.
WIF1	WIF1 Gene	This gene plays a role in Wnt protein-dependent signaling.
WAS	WAS Gene	This gene is involved in signal transduction and plays a role in cell communication and organization.
VTI1A	VTI1A Gene	This gene is involved in vesicular transport.
VHL	VHL Gene	This gene is involved in transcriptional repression and protein degradation.
VAV1	VAV1 Gene	This gene plays a role in signal transduction. It is involved in the development and activation of both B cells and T cells.
USP8	USP8 Gene	This gene plays a role in ubiquitin-dependent proteolysis and cell proliferation.
USP6	USP6 Gene	This gene is involved in the regulation of cellular ubiquitination. It also plays a role in promoting the recycling of endocytic vesicles to the plasma membrane.
UBR5	UBR5 Gene	This gene plays a role in protein ubiquitination.
U2AF1	U2AF1 Gene	This gene is involved in the splicing of mRNA.
TSHR	TSHR Gene	This gene plays an important role in the regulation of thyroid cell metabolism.
TRRAP	TRRAP Gene	This gene is involved in DNA repair and regulation of mitosis.
TRIP11	TRIP11 Gene	This gene plays a role in thyroid receptor binding.
TRIM33	TRIM33 Gene	This gene is involved in the mediation of protein ubiquitination.
TRIM27	TRIM27 Gene	This gene is involved in the differentiation of male germ cells.
TRIM24	TRIM24 Gene	This gene plays a role in hormone-dependent gene transcription.
PTPRB	PTPRB Gene	This gene is involved in dephosphorylation of proteins.
PTK6	PTK6 Gene	This gene plays a role in signal transduction.
PTEN	PTEN Gene	This gene plays a role in signal transduction and apoptosis. It is also involved in the regulation of cell cycle progression.
PTCH1	PTCH1 Gene	This gene is involved in tumor suppression and mutations in this gene have been associated with several cancers and cancer related diseases.
PSIP1	PSIP1 Gene	This gene is involved in regulation of transcription. It also plays a role in mediation of pre-mRNA splicing.
PRRX1	PRRX1 Gene	This gene plays a role in both transcriptional regulation and muscle cell development.
PRPF40B	PRPF40B Gene	This gene may be involved in mRNA splicing.
PRKCB	PRKCB Gene	This gene is involved in diverse cell processes such as apoptosis, B cell activation and endothelial cell proliferation.
PRKAR1A	PRKAR1A Gene	This gene plays a role in the regulation of protein kinase A.
PRKACA	PRKACA Gene	This gene is involved in the regulation of diverse cell processes including cell growth, proliferation, differentiation and motility.
PRF1	PRF1 gene	This gene is involved in cytolysis.
PREX2	PREX2 Gene	This gene is involved in guanine nucleotide exchange.
PRDM2	PRDM2 Gene	This gene is involved in both methylation of histone H3 and transcriptional regulation.
PRDM16	PRDM16 Gene	This gene plays a role in both transcriptional regulation and adipocyte differentiation.
PRDM1	PRDM1 Gene	This gene is involved in repression of transcription. It plays a role in the formation of pre-plasma memory B cells and immunoglobulin-secreting plasma cells.
PRCC	PRCC Gene	This gene may be involved in transcriptional regulation.
PPP6C	PPP6C Gene	This gene plays a role in both protein dephosphorylation and signaling.
PPP2R1A	PPP2R1A Gene	This gene plays a role in the regulation of cell growth and division.
PPM1D	PPM1D Gene	This gene plays a role in the modulation of cell cycle arrest.
PPFIBP1	PPFIBP1 Gene	This gene plays a role in protein-protein interactions.
PPARG	PPARG Gene	This gene plays a regulatory role in adipocyte differentiation.
POU5F1	POU5F1 Gene	This gene plays a role in early mammalian development.
POU2AF1	POU2AF1 Gene	This gene is involved in both humoral immunity and transcriptional regulation.
POT1	POT1 Gene	This gene plays a role in the regulation of telomere length.
POLQ	POLQ Gene	This gene is involved in DNA synthesis and repair.
POLG	POLG Gene	This gene plays a role in the replication of mitochondrial DNA.
POLE	POLE Gene	This gene is involved in both DNA replication and DNA base-excision repair.
POLD1	POLD1 Gene	This gene is involved in DNA replication and proofreading.
PMS2	PMS2 Gene	This gene is involved in mismatch repair and mutations in the gene result in hereditary non-polyposis colon cancer 4.
PMS1	PMS1 Gene	This gene is involved in mismatch repair and mutations in the gene result in hereditary non-polyposis colon cancer 3.
PML	PML Gene	This gene plays a role in tumor suppression and is involved in the regulation of p53 in response to oncogenic signal transduction.
CD274	CD274 Gene	This gene is involved in T cell activation and proliferation.
CD209	CD209 Gene	This gene plays a role in the regulation of host defense responses and mediates pathogen-binding properties.
CCR7	CCR7 gene	This gene plays a role in immune function.
CCNE1	CCNE1 Gene	This gene regulates the G1/S phase of the cell cycle by cyclin expression.
CCND3	CCND3 Gene	This gene is involved in cell cycle progression.
CCND2	CCND2 Gene	This gene is involved in the regulation of the G1/S phase of the cell cycle.
CCND1	CCND1 Gene	This gene plays a role in the regulation of mitotic events.
CCNC	CCNC Gene	This gene plays a role in the modulation of gene transcription.
CCNB1IP1	CCNB1IP1 Gene	This gene plays a role in both ubiquitination and cell cycle progression.
CCDC6	CCDC6 Gene	This gene may play a role in tumor suppression.
CBLC	CBLC Gene	This gene is involved in both ubiquitination and signaling.
CBLB	CBLB Gene	This gene plays a role in the regulation of T cell activation.
CBL	CBL Gene	This gene plays a role in signal transduction and the regulation of protein degradation.
CBFB	CBFB Gene	This gene is involved in hematopoiesis and osteogenesis.
CBFA2T3	CBFA2T3 Gene	This gene plays a role in transcriptional regulation.
CASP8	CASP8 Gene	This gene is involved in apoptosis, immune cell homeostasis, lymphocyte activation and immunoprotection.
CARS	CARS Gene	This gene is involved in transfer RNA metabolism.
CARD11	CARD11 Gene Immunodeficiency Syndrome	This gene plays a role in apoptotic regulation.: A deficiency of immune response or a disorder characterized by deficient immune response.
CANT1	CANT1 Gene	This gene plays a role in both nucleotide hydrolysis and signal transduction.
CAMTA1	CAMTA1 Gene	This gene is involved in both DNA binding and transcription.
PIM1	PIM1 Gene	This gene is involved in apoptosis, cell cycle regulation and signal transduction.
PIK3R1	PIK3R1 Gene	This gene is involved in phosphoinositol signaling.
OLIG2	OLIG2 Gene	This gene is involved in transcriptional regulation and oligodendrocyte and motor neuron differentiation. This gene may play a role in the development of brain tumors.
MDM4	MDM4 Gene	This gene plays a role in cell cycle arrest.
MAX	MAX Gene	This gene is involved in transcriptional regulation and plays a role in the mediation of DNA-protein interactions.
MAPK1	MAPK1 Gene	This gene plays a role in signal transduction and positive regulation of the cell cycle.
MTOR	MTOR Gene	This gene plays a role in apoptosis, cell growth, differentiation and proliferation.
WDCP	WDCP Gene	This gene plays a role in binding to tyrosine-protein kinase HCK.
KNL1	KNL1 Gene	This gene is involved in both signaling and chromosome alignment in mitosis.
SHTN1	SHTN1 Gene	This gene is involved in neuronal polarization.
SNX29	SNX29 Gene	This gene may be involved in signal transduction or lipid binding.
NSD2	NSD2 Gene	This gene plays a role in histone-lysine methylation.
NSD3	NSD3 Gene	This gene is involved in histone methylation.
PATZ1	PATZ1 Gene	This gene is involved in transcriptional regulation.
SIRPA	SIRPA Gene	This gene is involved in cellular signal transduction and tyrosine kinase-coupled signaling processes.
SH3GL1	SH3GL1 Gene	This gene may be involved in endocytosis.
SH2B3	SH2B3 Gene	This gene plays a role in T-cell activation.
SGK1	SGK1 Gene	This gene plays a role in both protein phosphorylation and cellular stress response.
SFPQ	SFPQ Gene	This gene may be involved in both transcriptional regulation and nuclear RNA processing.
SF3B1	SF3B1 Gene	This gene is involved in mRNA splicing.
SETD2	SETD2 Gene	This gene is involved in epigenetic control of gene expression.
SETBP1	SETBP1 Gene	This gene may be involved in the modulation of protein SET activity.
SET	SET Gene	This gene is involved in apoptosis, biogenesis, DNA replication and nuclear organization.
SDHD	SDHD Gene	This gene plays a role in the localization of succinate dehydrogenase activity.
SDHC	SDHC Gene	This gene is involved in mitochondrial electron transport.
SDHB	SDHB Gene	This gene plays a role in electron transport in the mitochondria.
SDHAF2	SDHAF2 Gene	This gene is involved in the electron transport chain.
SDHA	SDHA Gene	This gene is involved in the mitochondrial respiratory chain.
SDC4	SDC4 Gene	This gene is involved in cell-matrix interactions.
SBDS	SBDS Gene	This gene plays a role in ribosome formation.
SALL4	SALL4 Gene	This gene plays a role in both transcriptional regulation and stem cell maintenance.
S100A7	S100A7 Gene	This gene is involved in both calcium binding and antimicrobial activity.
RUNX1T1	RUNX1T1 Gene	This gene plays a role in transcriptional regulation and hematopoiesis.
RUNX1	RUNX1 Gene	This gene plays a role in transcriptional regulation and cytogenetic aberrations are associated with several leukemias.
RSPO3	RSPO3 Gene	This gene is thought to be involved in transport; however, a function has yet to be elucidated.
RSPO2	RSPO2 Gene	This gene plays a role in both Wnt signaling and embryonic morphogenesis.
RPN1	RPN1 Gene	This gene plays a role in post-translational protein modification.
RPL5	RPL5 Gene	This gene plays a role in ribosome assembly.
RPL22	RPL22 Gene	This gene is involved in translation.
RPL10	RPL10 Gene	This gene plays a role in protein biosynthesis. It is also involved in signal transduction.
ROS1	ROS1 Gene	This gene plays a role in receptor tyrosine phosphorylation signal transduction, and is thought to play a role in cellular growth or differentiation, but an exact function has not been substantiated.
ROBO2	ROBO2 Gene	This gene plays a role in ligand binding, axon guidance and cell migration.
RNF43	RNF43 Gene	This gene is involved in both protein ubiquitination and the Wnt signaling pathway.
RNF213	RNF213 Gene	This gene may be involved in ubiquitination.
MTCP1	MTCP1 Gene	This gene plays a role in the proliferation of T cells and is involved in cell cycle regulation.
MSN	MSN Gene Immunodeficiency Syndrome	This gene plays a role in both cell adhesion and cytoskeleton modeling.: A deficiency of immune response or a disorder characterized by deficient immune response.
MSI2	MSI2 Gene	This gene is involved in translational regulation.
MSH6	MSH6 Gene	This gene is involved in mismatch repair and plays a role in several cancers.
MSH2	MSH2 Gene	This gene plays a role in DNA mismatch repair mutations in the gene result in hereditary nonpolyposis colorectal cancer-1.
MPL	MPL Gene	This gene plays a regulatory role in megakaryocytopoiesis and platelet formation.
MNX1	MNX1 Gene	This gene plays a role in both the regulation of transcription and DNA binding.
MN1	MN1 Gene	This gene is involved in tumor suppression.
MLLT6	MLLT6 Gene	This gene is involved in transcriptional regulation and aberrations in the gene are associated with acute leukemias due to chromosomal translocations.
MLLT4	AFDN Gene	This gene is involved in cell adhesion and cytoskeletal modeling.
MLLT3	MLLT3 Gene	This gene plays a role in transcriptional regulation and translocations in the gene are associated with leukemia.
MLLT11	MLLT11 Gene	This gene is involved in mitochondrial functions.
MLLT10	MLLT10 Gene	This gene may be involved in transcriptional regulation.
MLLT1	MLLT1 Gene	This gene is involved in transcriptional regulation and translocations in the gene are associated with acute leukemia.
MLH1	MLH1 Gene	This gene plays a role in DNA mismatch repair.
MLF1	MLF1 Gene	This gene plays a role in both transcriptional regulation and cell cycle arrest.
MITF	MITF Gene	This gene is involved in transcriptional promotion in melanocytes.
MGMT	MGMT Gene	This gene is involved in DNA repair.
MET	MET Gene	This gene plays a regulatory role in the modulation of cell-surface receptors and hepatocyte growth factor interactions.
MEN1	MEN1 Gene	This gene is involved in transcriptional regulation and has tumor suppressor activity.
MED12	MED12 Gene	This gene plays a role in the regulation of RNA polymerase II-dependent transcription.
MECOM	MECOM Gene	This gene plays a role in transcriptional activation. Retroviral activation of the gene plays an important role in the translocations leading to myeloid leukemia/myelodysplastic syndrome.
MDS2	MDS2 Gene	This gene plays a role in myelodysplastic syndrome.
MDM2	MDM2 Gene	This gene plays a role in several cellular processes related to cellular viability; including the cell cycle and apoptosis.
MB21D2	MB21D2 Gene	This gene plays a role in protein-protein interactions.
MAP3K13	MAP3K13 Gene	This gene is involved in both protein phosphorylation and signaling.
MAP3K1	MAP3K1 Gene	This gene plays a role in mediating cellular responses to growth factors, metabolic stimuli and mitogens.
MAP2K4	MAP2K4 Gene	This gene is involved in MAPK signaling.
MAP2K2	MAP2K2 Gene	This gene plays a role in both protein phosphorylation and signal transduction.
MAP2K1	MAP2K1 Gene	This gene plays a role in signal transduction and regulation of transcription. It is also involved in cell differentiation, growth and proliferation.
MAML2	MAML2 Gene	This gene plays a role in transcriptional regulation and signal transduction.
MALT1	MALT1 Gene Immunodeficiency Syndrome	This gene plays a role in signal transduction and in the pathology of mucosa-associated lymphoid tissue lymphomas.: A deficiency of immune response or a disorder characterized by deficient immune response.
MALAT1	MALAT1 Gene	This gene may play a role in carcinogenesis.
MAFB	MAFB Gene	This gene plays a role in both hematopoiesis and transcriptional modulation.
MAF	MAF Gene	This gene plays a role in transcriptional regulation and cellular differentiation.
LZTR1	LZTR1 Gene	This gene may be involved in Golgi stabilization, embryogenesis or transcriptional regulation.
PTPN6	PTPN6 Gene	This gene plays a role in the regulation of multiple signaling pathways in hematopoietic cells.
PTPN13	PTPN13 Gene	This gene is involved in both protein dephosphorylation and signal transduction.
PTPN11	PTPN11 Gene	This gene plays a role in the regulation of cell signaling. It is involved in cell migration, metabolic control, mitogenic activation and gene transcription.
LYL1	LYL1 Gene	This gene plays a role in transcriptional regulation and is involved in the pathogenesis of acute lymphoblastic leukemia.
LSM14A	LSM14A Gene	This gene plays a role in the storage of mRNA.
LRP1B	LRP1B Gene	This gene plays a role in low density lipoprotein metabolism.
LRIG3	LRIG3 Gene	This gene may be involved in signaling.
LPP	LPP Gene	This gene may be involved in cell shape and cell motility.
LMO2	LMO2 Gene	This gene plays a crucial role in hematopoietic development and is involved in transcriptional activation.
LMO1	LMO1 Gene	This gene is involved in the regulation of transcription.
LIFR	LIFR Gene	This gene plays a critical role in cell fate and proliferation in both embryonic and adult cells.
LHFP	LHFPL6 Gene	This gene may play a role in cell adhesion or cell proliferation.
LEF1	LEF1 Gene	This gene plays a role in both signal transduction and transcription.
LCP1	LCP1 Gene	This gene plays a role in cytoskeletal remodeling.
LCK	LCK Gene	This gene is involved in signal transduction and the development/function of T cells.
LASP1	LASP1 Gene	This gene is involved in actin-dependent ion transport.
LARP4B	LARP4B Gene	This gene is involved in RNA metabolism and translation.
KTN1	KTN1 Gene	This gene plays a role in kinesin function.
KRAS	KRAS Gene	This gene is involved in signal transduction and apoptosis.
KNSTRN	KNSTRN Gene	This gene plays a role in both mitotic spindle formation and chromosome segregation.
FIP1L1	FIP1L1 Gene	This gene is involved in mRNA processing.
FHIT	FHIT Gene	This gene is involved in nucleotide metabolism and cell cycle control.
FH	FH Gene	This gene plays a role in the Krebs cycle.
FGFR4	FGFR4 Gene	This gene plays a role in mitogenesis and differentiation.
FGFR3	FGFR3 Gene	This gene plays a role in bone development and maintenance and mutations in the gene are associated with craniosynostosis and several types of skeletal dysplasia.
FGFR2	FGFR2 Gene	This gene plays a role in mitogenesis and differentiation and mutations in the gene are associated with craniosynostotic syndromes and bone malformations.
FGFR1OP	FGFR1OP Gene	This gene is involved in the regulation of cell shape, polarity and motility.
FGFR1	FGFR1 Gene	This gene plays a role in mitogenesis and differentiation.
FEV	FEV Gene	This gene may play a role in transcriptional repression.
FES	FES Gene	This gene is involved in hematopoiesis and the maintenance of cellular transformation.
FEN1	FEN1 Gene	This gene is involved in DNA replication and repair.
FCRL4	FCRL4 Gene	This gene may be involved in B cell receptor signaling.
FCGR2B	FCGR2B Gene	This gene plays a role in the inhibition of immune functions and cellular proliferation.
FBXW7	FBXW7 Gene	This gene is involved in ubiquitin-dependent proteolysis and regulation of the G1-S cell cycle checkpoint.
FBXO11	FBXO11 Gene	This gene plays a role in the recognition of proteins to be ubiquitinylated.
FBLN2	FBLN2 Gene	This gene plays a role in protein-protein interactions in the extracellular matrix.
FAT4	FAT4 Gene	This gene plays a role in planar cell polarity.
FAT3	FAT3 Gene	This gene is involved in cell adhesion and neurite development.
FAT1	FAT1 Gene	This gene is involved in both cellular polarization and cell-cell adhesion.
FAS	FAS Gene	This gene is involved in the mediation of cellular surface receptors and apoptotic signals.
FANCG	FANCG Gene	This gene is involved in the maintenance of genomic integrity and nuclear signal transduction. Allelic variants of the gene are involved in Fanconi syndrome.
FANCF	FANCF Gene	This gene may be involved in the regulation of DNA repair.
FANCE	FANCE Gene	This gene plays a role in the regulation of both DNA repair and protein localization.
FANCD2	FANCD2 Gene	This gene is involved in the regulation of meiosis, DNA repair and the cell cycle.
FANCC	FANCC Gene	This gene may play a role in DNA cross-link repair.
FANCA	FANCA Gene	This gene may be involved in the mediation of DNA repair.
FAM47C	FAM47C Gene	This gene has no known function.
FAM46C	FAM46C Gene	This gene may play a role in malignant melanoma.
FAM135B	FAM135B Gene	This gene may play a role in the metabolism of lipids.
FAM131B	FAM131B Gene	This gene has not been characterized.
EZR	EZR Gene	This gene plays a role in cellular structure.
EZH2	EZH2 Gene	This gene plays a role in chromatin remodeling and transcriptional regulation.
EXT2	EXT2 Gene	This gene is involved in the heparin/heparin sulfate biosynthesis, cell organization/biogenesis and development of the cytoskeleton in chondrocytes.
EXT1	EXT1 Gene	This gene plays a role in heparin/heparin sulfate biosynthesis, axon guidance and biogenesis/cell organization.
EWSR1	EWSR1 Gene	This gene may play a role in post-transcriptional regulation; however the function remains to be elucidated. Mutations in the gene result in Ewing sarcoma and other tumors.
ETV6	ETV6 Gene	This gene plays a regulatory role in transcription and in matrix metalloproteinase activity.
ETV5	ETV5 Gene	This gene plays a role in the regulation of gene transcription.
ETV4	ETV4 Gene	This gene plays a regulatory role in transcription and in matrix metalloproteinase activity.
ETV1	ETV1 Gene	This gene is involved in transcriptional activation and spinal cord development.
KMT2D	KMT2D Gene	This gene plays a role in co-activation of gene expression.
KMT2C	KMT2C Gene 	This gene plays a role in both methylation and transcriptional regulation
KMT2A	KMT2A Gene	This gene is involved in transcriptional regulation and alterations in the gene are associated with acute lymphoblastic leukemia.
KLK2	KLK2 Gene	This gene plays a role in proteolysis.
KLF6	KLF6 Gene	This gene plays a role in transcriptional activation.
KLF4	KLF4 Gene	This gene plays a role in gene transcription.
KIT	KIT Gene	This gene plays a role in cellular hematopoiesis and differentiations. Mutations in the gene are associated with several diseases, including acute myelogenous leukemia, gastrointestinal tumors, and mast cell disease.
KIF5B	KIF5B Gene	This gene is involved in the transport of vesicles along microtubules.
KIAA1549	KIAA1549 Gene	This gene may play a role in brain functions.
KEAP1	KEAP1 Gene	This gene is involved in ubiquitin-mediated protein degradation.
KDR	KDR Gene	This gene plays a role in angiogenesis and vascular regulation.
KDM6A	KDM6A Gene	This gene is involved in the modulation of histone methylation.
KDM5C	KDM5C Gene	This gene is involved in histone modification.
KDM5A	KDM5A Gene	This gene plays a role in transcriptional modulation.
KCNJ5	KCNJ5 Gene	This gene is involved in ion transport.
KAT7	KAT7 Gene	This gene is involved in epigenetic control of gene expression.
KAT6B	KAT6B Gene	This gene plays a role in both transcription and histone acetylation.
KAT6A	KAT6A Gene	This gene is involved in both histone acetylation and transcriptional regulation.
JUN	JUN Gene	This gene plays a critical role in transcriptional regulation and cellular growth.
JAZF1	JAZF1 Gene	This gene may be involved in transcriptional regulation.
JAK3	JAK3 Gene	This gene plays a role in signal transduction.
JAK2	JAK2 Gene	This gene is involved in erythropoiesis and signal transduction.
JAK1	JAK1 Gene	This gene plays a role in signal transduction.
ITK	ITK Gene	This gene is involved in the differentiation and proliferation of T cells.
ITGAV	ITGAV Gene	This gene plays a role in cell communication and angiogenesis.
ISX	ISX Gene	This gene is involved in gene expression regulation in the intestine.
IRS4	IRS4 Gene	This gene plays a role in signal transduction and ligand binding.
IRF4	IRF4 Gene	This gene is involved in the regulation of B-cell differentiation and proliferation. It also plays a role in mediating the proliferation of mitogen-stimulated T cells.
IL7R	IL7R Gene	This gene is involved in the regulation of lymphopoiesis.
IL6ST	IL6ST Gene	This gene plays a role in signal transduction and is putatively involved in embryonic development.
IL21R	IL21R Gene Immunodeficiency Syndrome	This gene is involved in cytokine recognition.: A deficiency of immune response or a disorder characterized by deficient immune response.
IL2	IL2 Gene	This gene is involved in growth and lymphokine regulation.
IKZF1	IKZF1 Gene Immunodeficiency Syndrome	This gene is involved in B-cell and T-cell maturation.: A deficiency of immune response or a disorder characterized by deficient immune response.
IKBKB	IKBKB Gene Immunodeficiency Syndrome	This gene is involved in protein phosphorylation.: A deficiency of immune response or a disorder characterized by deficient immune response.
IGL	Immunoglobulin Lambda Locus	This region represents the germline organization of the lambda light chain locus. The locus includes V (variable), J (joining), and C (constant) segments. During B cell development, a recombination event at the DNA level joins a single V segment with a J segment; the C segment is later joined by splicing at the RNA level. Recombination of many different V segments with several J segments provides a wide range of antigen recognition. Additional diversity is attained by junctional diversity, resulting from the random additional of nucleotides by terminal deoxynucleotidyltransferase, and by somatic hypermutation, which occurs during B cell maturation in the spleen and lymph nodes. (from LocusLink)
ETNK1	ETNK1 Gene	This gene plays a role in phospholipid biosynthesis.
ERG	ERG Gene	This gene plays a regulatory role in transcription, cellular maintenance and hematopoiesis.
ERCC5	ERCC5 Gene	This gene plays a role in the nucleotide base excision repair of UV-induced DNA damage and mutations of the gene cause Cockayne syndrome.
ERCC4	ERCC4 Gene	This gene is involved in nucleotide excision repair and is involved in the correction of defective nucleotide excision repair in xeroderma pigmentosum cells of complementation group F.
ERCC3	ERCC3 Gene	This gene is involved in DNA excision repair and transcription.
ERCC2	ERCC2 Gene	This gene is involved in nucleotide excision repair and corrects sensitivity to UV radiation and defective nucleotide excision repair in xeroderma pigmentosum cells of complementation group D.
ERC1	ERC1 Gene	This gene plays a role in signaling.
ERBB4	ERBB4 Gene	This gene is involved in neuronal development and plays a role in receptor tyrosine kinase signal transduction that regulates cellular proliferation and differentiation.
IGK	Immunoglobulin Kappa Locus	This region represents the germline organization of the kappa light chain locus. The locus includes V (variable), J (joining), and C (constant) segments. During B cell development, a recombination event at the DNA level joins a single V segment with a J segment; the C segment is later joined by splicing at the RNA level. Recombination of many different V segments with several J segments provides a wide range of antigen recognition. Additional diversity is attained by junctional diversity, resulting from the random additional of nucleotides by terminal deoxynucleotidyltransferase, and by somatic hypermutation, which occurs during B cell maturation in the spleen and lymph nodes. (from LocusLink)
IGH	Immunoglobulin Heavy Locus	This region represents the germline organization of the immunoglobulin heavy chain locus. The locus includes V (variable), J (joining), diversity (D), and C (constant) segments. During B cell development, a recombination event at the DNA level joins a D segment with a J segment; a V segment is then joined to the D-J gene. The C segment is later joined by splicing at the RNA level. Recombination of many different V segments with several D and J segments provides a wide range of antigen recognition. Additional diversity is attained by junctional diversity, resulting from the random additional of nucleotides by terminal deoxynucleotidyltransferase, and by somatic hypermutation, which occurs during B cell maturation in the spleen and lymph nodes. (from LocusLink)
IDH2	IDH2 Gene	This gene plays a role in intermediary metabolism.
IDH1	IDH1 Gene	This gene plays a role in carbohydrate metabolism.
ID3	ID3 Gene	This gene plays a role in transcriptional repression.
HSP90AB1	HSP90AB1 Gene	This gene plays a role in both interferon signaling and protein folding.
HSP90AA1	HSP90AA1 Gene	This gene is involved in both protein folding and nitric oxide metabolism.
HRAS	HRAS Gene	This gene plays a role in signal transduction and cellular communication.
HOXD13	HOXD13 Gene	This gene plays a role in the development of limbs and appendages.
HOXD11	HOXD11 Gene	This gene is involved in limb morphogenesis.
HOXC13	HOXC13 Gene	This gene plays a role in the modulation of transcription.
HOXC11	HOXC11 Gene	This gene is involved in embryological development.
HOXA9	HOXA9 Gene	This gene plays a role in transcriptional regulation, morphogenesis and differentiation.
HOXA13	HOXA13 Gene	This gene plays a role in transcriptional modulation.
HOXA11	HOXA11 Gene	This gene is involved in embryologic pattern formation.
HOOK3	HOOK3 Gene	This gene plays a role in endocytosis and Golgi maintenance.
HNRNPA2B1	HNRNPA2B1 Gene	This gene is involved in RNA processing and transport.
HNF1A	HNF1A Gene	This gene plays a role in both DNA binding and transcriptional modulation.
HMGN2P46	HMGN2P46 Gene	This gene may be involved in prostate functions.
HMGA2	HMGA2 Gene	This gene is involved in chromatin organization and regulation of gene transcription. It also plays a role in development.
HMGA1	HMGA1 Gene	This gene plays a role in a number of cellular processes including apoptosis, chromatin organization and transcriptional regulation.
HLF	HLF Gene	This gene is involved in both transcriptional regulation and DNA binding.
HIST1H4I	HIST1H4I Gene	This gene plays a role in nucleosomal structure.
HIST1H3B	HIST1H3B Gene	This gene is involved in chromatin structure.
HIP1	HIP1 Gene	This gene plays a role in both vesicle coat formation and endocytosis.
HIF1A	HIF1A Gene	This gene plays a role in cardiovascular development and systemic oxygen homeostasis.
HEY1	HEY1 Gene	This gene is involved in both transcription factor binding and transcriptional repression.
HERPUD1	HERPUD1 Gene	This gene is involved in the response to endoplasmic reticulum stress.
H3F3B	H3F3B Gene	This gene plays a role in nucleosome assembly.
H3F3A	H3F3A Gene	This gene is involved in chromatin structure.
GRM3	GRM3 Gene	This gene is involved in ligand-depending signaling.
GRIN2A	GRIN2A Gene	This gene is involved in the regulation of ion transport.
GPHN	GPHN Gene	This gene is involved in vitamin metabolism.
GPC3	GPC3 Gene	This gene is involved in heparin sulfate binding.
GOPC	GOPC Gene	This gene plays a role in protein transport.
GOLGA5	GOLGA5 Gene	This gene is involved in Golgi maintenance.
GNAS	GNAS Gene	This gene plays a role in signal transduction and is associated with pituitary tumors.
GNAQ	GNAQ Gene	This gene plays a role in signal transduction and is involved in calcium signaling.
RMI2	RMI2 Gene	This gene is involved in DNA replication.
RHOH	RHOH Gene	This gene plays a role in signal transduction in hematopoietic cells.
RHOA	RHOA Gene	This gene plays a role in signal transduction. It is involved in several cellular functions including cell differentiation and cytoskeletal remodeling.
RGS7	RGS7 Gene	This gene plays a role in the inhibition of both G protein-coupled receptor signaling and signal transduction.
RGPD3	RGPD3 Gene	This gene may play a role in the localization of the GTPase Ran.
RET	RET Gene	This gene plays an essential role in neural crest development, cellular growth and differentiation. Mutations in the gene are associated with a variety of neoplasias and carcinomas.
REL	REL Gene	This gene is involved in transcriptional regulation and signal transduction through the nuclear factor kappa B NFKB signal transduction pathway.
RECQL4	RECQL4 Gene	This gene is involved in the initiation of DNA replication and sister-chromatid cohesion.
RBM15	RBM15 Gene	This gene plays a role in RNA binding.
RBM10	RBM10 Gene	This gene is involved in RNA binding and processing.
RB1	RB1 Gene	This gene is involved in the regulation of cell differentiation, growth and proliferation.
RARA	RARA Gene	This gene plays a role in transcription and retinoic acid receptor signal transduction.
RAP1GDS1	RAP1GDS1 Gene	This gene is involved in guanine nucleotide exchange.
RANBP2	RANBP2 Gene	This gene is involved in both SUMOylation and nuclear transport.
RALGDS	RALGDS Gene	This gene plays a role in signal transduction and cytoskeletal remodeling. It is also involved in regulation of cell growth.
RAF1	RAF1 Gene	This gene is involved in cell growth, proliferation, differentiation and migration. It also plays a role in apoptosis.
RAD51B	RAD51L1 Gene	This gene plays a role in the mediation of homologous recombinational repair of DNA.
RAC1	RAC1 Gene	This gene is involved in both cell motility and signal transduction.
RABEP1	RABEP1 Gene	This gene is involved in the regulation of both GTPase activity and endocytosis.
QKI	QKI Gene	This gene is involved in both the biosynthesis and maintenance of mRNA.
PWWP2A	PWWP2A Gene	This gene may play a role in protein-protein or protein-DNA interactions.
PTPRT	PTPRT Gene	This gene plays a role in the control of motor axon guidance.
PTPRK	PTPRK Gene	This gene is involved in receptor signaling, cell-cell contact and cell migration.
GMPS	GMPS Gene	This gene plays a role in nucleotide biosynthesis.
GATA3	GATA3 Gene	This gene plays a role in the modulation of transcription.
GATA2	GATA2 Gene Immunodeficiency Syndrome	This gene is involved in both DNA binding and transcriptional regulation.: A deficiency of immune response or a disorder characterized by deficient immune response.
GATA1	GATA1 Gene	This gene is involved in erythropoiesis and transcriptional activation.
GAS7	GAS7 Gene	This gene may play a role in neuronal development.
FUS	FUS Gene	This gene is involved in gene expression, genomic integrity and RNA processing.
FUBP1	FUBP1 Gene	This gene plays a role in transcriptional modulation.
FSTL3	FSTL3 Gene	This gene plays a role in a variety of processes including transcription.
FOXR1	FOXR1 Gene	This gene plays a role in DNA binding and transcriptional regulation.
FOXP1	FOXP1 Gene	This gene is involved in transcriptional modulation.
FOXO4	FOXO4 Gene	This gene plays a role in smooth muscle cell differentiation, cellular growth, cell cycle regulation and tumor suppression.
FOXO3	FOXO3 Gene	This gene is involved in transcriptional regulation and apoptosis.
FOXO1	FOXO1 Gene	This gene is involved in transcriptional regulation and may play a role in myogenic growth and differentiation.
FOXL2	FOXL2 Gene	This gene plays a role in ovarian function.
FOXA1	FOXA1 Gene	This gene plays a role in the modulation of gene expression.
FNBP1	FNBP1 Gene	This gene plays a role in endocytosis.
FLT4	FLT4 Gene	This gene plays an essential role in the development of embryonic cardiovasculature and lymphatic vessel formation.
FLNA	FLNA Gene	This gene is involved in remodeling of the cytoskeleton.
FLI1	FLI1 Gene	This gene plays a role in transcriptional activation and has been implicated in the pathogenesis of neuroepithelioma.
FLCN	FLCN Gene	This gene may play a role in tumor suppression.
FKBP9	FKBP9 Gene	This gene is involved in chaperone-mediated protein folding.
BCR	BCR Gene	This gene plays a role in signal transduction.
PLAG1	PLAG1 Gene	This gene is involved in cellular proliferation.
PIK3CB	PIK3CB Gene	This gene is involved in apoptosis, cell growth and angiogenesis.
PICALM	PICALM Gene	This gene plays a role in receptor mediated endocytosis.
PHOX2B	PHOX2B Gene	This gene plays a role in the regulation of transcription.
PHF6	PHF6 Gene	This gene plays a role in transcriptional regulation.
PER1	PER1 Gene	This gene is involved in circadian rhythm.
PDGFRB	PDGFRB Gene	This gene plays a role in mitogenic activities affecting mesenchymal cells and a translocation in the gene results in chronic myelomonocytic leukemia.
PDGFRA	PDGFRA gene	This gene plays a role in mitogenic activities affecting mesenchymal cells and is involved in receptor tyrosine kinase signal transduction.
PDGFB	PDGFB Gene	This gene is involved in cellular growth and proliferation. It is also plays a role in intercellular signaling.
PDE4DIP	PDE4DIP Gene	This gene plays a role in protein complex localization.
PDCD1LG2	PDCD1LG2 Gene	This gene plays a role in the regulation of T-cell proliferation.
PCM1	PCM1 Gene	This gene is involved in centrosome formation.
PCBP1	PCBP1 Gene	This gene plays a role in RNA splicing.
PBX1	PBX1 Gene	This gene plays a role in the modulation of transcription.
PBRM1	PBRM1 Gene	This gene plays a role in chromatin remodeling.
PAX8	PAX8 Gene	This gene is involved in thyroid development and transcriptional regulation.
PAX7	PAX7 Gene	This gene plays a role in the transcriptional regulation of target genes. It is involved in pattern formation during embryogenesis.
PAX5	PAX5 Gene	This gene is involved in the transcriptional regulation of target genes. It plays a role in B-cell differentiation, neural development and spermatogenesis.
PAX3	PAX3 Gene	This gene plays a role in the transcriptional activation of target genes. It is involved in melanogenesis, neurogenesis and skeletal muscle development.
PALB2	PALB2 Gene	This gene may play a role in the repair of DNA damage that is resolved by recombination.
PAFAH1B2	PAFAH1B2 Gene	This gene is involved in lipid metabolism.
PABPC1	PABPC1 Gene	This gene is involved in binding to poly(A)RNA.
P2RY8	P2RY8 Gene	This gene plays a role in signaling.
OMD	OMD Gene	This gene is involved in cell adhesion.
NUTM2B	NUTM2B Gene	The function of this gene is unknown.
NUTM2A	NUTM2A Gene	This gene has an unknown function.
NUTM1	NUTM1 Gene	This gene may be involved in testicular function.
NUP98	NUP98 Gene	This gene plays a role in transport and is frequently overexpressed in prostate cancers.
NUP214	NUP214 Gene	This gene plays a critical role in nuclear transport and docking regulation. Alterations in the gene have been associated with several cancers and leukemias.
NUMA1	NUMA1 Gene	This gene plays an essential role in normal mitosis. It is also involved in cell organization/biogenesis.
NTRK3	NTRK3 Gene	This gene plays a role in neuronal development and cellular differentiation. Mutations in the gene are associated with medulloblastomas, secretory breast carcinomas and other cancers.
NTRK1	NTRK1 Gene	This gene is involved in cellular differentiation and neurotrophic functions.
NTHL1	NTHL1 Gene	This gene plays a role in nucleotide-excision DNA repair.
NSD1	NSD1 Gene	This gene is involved in the mediation of histone methylation.
NRG1	NRG1 Gene	This gene plays a role in cellular differentiation, growth and proliferation.
NRAS	NRAS Gene	This gene plays a role in signal transduction and cell cycle regulation.
NR4A3	NR4A3 Gene	This gene is involved in the modulation of transcription.
NPM1	NPM1 Gene	This gene is involved in the regulation of ribosomal assembly.
NOTCH2	NOTCH2 Gene	This gene plays a role in cell-cell signaling.
NOTCH1	NOTCH1 Gene	This gene is involved in intercellular signal transduction that plays a key role in development.
NONO	NONO Gene	This gene may play a role in both transcriptional regulation and nuclear RNA processing.
NKX2-1	NKX2-1 Gene	This gene plays a role in thyroid gene transcription.
NIN	NIN Gene	This gene is involved in the localization of the centrosome.
NFKBIE	NFKBIE Gene	This gene plays a role in signal transduction and regulation of transcription. It is involved in the immune response.
NFKB2	NFKB2 Gene Immunodeficiency Syndrome	This gene plays a role in transcriptional regulation, signal transduction and inflammatory responses.: A deficiency of immune response or a disorder characterized by deficient immune response.
NFIB	NFIB Gene	This gene plays a role in transcriptional regulation and mediates DNA-binding interactions.
NFE2L2	NFE2L2 Gene	This gene plays a role in transcriptional regulation.
NFATC2	NFATC2 Gene	This gene is involved in cytokine gene transcription.
NF2	NF2 Gene	This gene plays a role in cell adhesion and cytoskeletal remodeling. It is also involved in suppression of cell growth.
NF1	NF1 Gene	This gene plays a role in signal transduction and cytoskeletal remodeling.
NDRG1	NDRG1 Gene	This gene plays a role in cellular stress responses. It is also involved in both cell growth and differentiation.
NCOR2	NCOR2 Gene	This gene plays a role in repression of transcription. It is also involved in chromatin remodeling.
NCOR1	NCOR1 Gene	This gene is involved in chromatin remodeling and repression of transcription.
NCOA4	NCOA4 Gene	This gene is involved in the transcriptional activation of target genes.
NCOA2	NCOA2 Gene	This gene is involved in regulation of transcription. It also plays a role in myogenic differentiation.
NCOA1	NCOA1 Gene	This gene plays a role in regulation of transcription.
NCKIPSD	NCKIPSD Gene	This gene plays a role in stress fiber formation.
NBN	NBN Gene	This gene plays a role in DNA repair and cell cycle checkpoints.
NBEA	NBEA Gene	This gene plays a role in membrane-targeting of protein kinase A.
NACA	NACA Gene	This gene plays a role in protein sorting.
NAB2	NAB2 Gene	This gene plays a role in the repression of gene transcription.
MYOD1	MYOD1 Gene	This gene plays a role in DNA binding and myogenesis.
MYO5A	MYO5A Gene	This gene is involved in vesicle transport along actin filaments.
MYH9	MYH9 Gene	This gene is involved in both cytoskeleton modeling and cytokinesis.
MYH11	MYH11 Gene	This gene plays a regulatory role in muscle contraction and the required ATP hydrolysis.
MYD88	MYD88 Gene	This gene is involved in the modulation of proinflammatory gene expression.
MYCN	MYCN Gene	This gene is involved in transcriptional regulation and amplification of this gene is associated with a variety of tumors, most notably neuroblastomas.
MYCL	MYCL1 Gene	This gene is involved in transcriptional regulation and is frequently amplified in small-cell lung cancer.
MYC	MYC Gene	This gene plays a role in cell cycle progression and apoptosis. Cytogenetic aberrations in the gene are involved in cellular transformation and are associated with a variety of hematopoietic tumors, leukemias and lymphomas.
MYB	MYB Gene	This gene plays a role in hematopoietic cell proliferation and development.
MUTYH	MUTYH Gene	This gene plays a role in the repair of oxidative DNA damage.
MUC16	MUC16 Gene	This gene is involved in both cellular adhesion and the maintenance of mucosal surfaces.
SPOP	SPOP Gene	This gene may be involved in both transcriptional repression and protein ubiquitination.
SPEN	SPEN Gene	This gene plays a role in hormone-mediated transcriptional regulation.
SPECC1	SPECC1 Gene	This gene may be involved in nuclear structure.
SOX2	SOX2 Gene	This gene is involved in embryonic development and in the determination of cell fate.
SOCS1	SOCS1 Gene	This gene is involved in the attenuation of cytokine signaling.
SND1	SND1 Gene	This gene plays a role in both transcriptional regulation and RNA interference.
SMO	SMO Gene	This gene plays a role in G protein-coupled receptor signal transduction and sonic hedgehog pathway activation.
SMC1A	SMC1A Gene	This gene is involved in maintenance of sister chromatid cohesion during mitosis.
SMARCE1	SMARCE1 Gene	This gene is involved in chromatin remodeling and regulation of transcription.
SMARCD1	SMARCD1 Gene	This gene plays a role in chromatin remodeling and regulation of transcription.
SMARCB1	SMARCB1 Gene	This gene plays a role in chromatin remodeling and regulation of transcription.
SMARCA4	SMARCA4 Gene	This gene plays a role in chromatin remodeling, cell cycle control and regulation of transcription.
SMAD4	SMAD4 Gene	This gene plays a role in signal transduction and transcriptional activation. It is also involved in suppression of angiogenesis.
SMAD3	SMAD3 Gene	This gene is involved in signal transduction and apoptosis. It also plays a role in the regulation of both steroid synthesis and T-cell response.
SMAD2	SMAD2 Gene	This gene plays a role in signal transduction and repression of transcription.
SLC45A3	SLC45A3 Gene	This gene plays a role in transmembrane transport.
SLC34A2	SLC34A2 Gene	This gene plays a role in phosphate transport.
SKI	SKI Gene	This gene is involved in transcriptional regulation and is involved in cellular signal transduction.
